Fylkenummer;Fylkenavn;Kommunenummer;Kommunenavn;Stemmekretsnummer;Stemmekretsnavn;Antall stemmeberettigede;Godkjente stemmegivninger — Forhånd;Godkjente stemmegivninger - Valgting;Godkjente stemmegivninger - Totalt;Forkastede stemmegivninger - Forhånd;Forkastede stemmegivninger - Totalt;Godkjente stemmesedler - Forhånd;Godkjente stemmesedler - Valgting;Godkjente stemmesedler - Totalt;Forkastede stemmesedler - Forhånd;Forkastede stemmesedler - Totalt;Blanke stemmesedler - Forhånd;Blanke stemmesedler - Totalt;
01;Østfold;0101;Halden;;;24331;2143;11744;13887;0;15;2133;11736;13869;14;36;22;183;
01;Østfold;0104;Moss;;;25362;2762;12269;15031;1;13;2727;12234;14961;28;32;17;115;
01;Østfold;0105;Sarpsborg;;;42905;3805;18504;22309;5;15;3781;18447;22228;15;45;24;164;
01;Østfold;0106;Fredrikstad;;;62398;5839;27685;33524;0;43;5825;27572;33397;6;20;39;314;
01;Østfold;0111;Hvaler;;;3701;473;2013;2486;0;5;470;2002;2472;3;3;4;22;
01;Østfold;0118;Aremark;;;1122;99;697;796;0;0;99;694;793;0;1;0;4;
01;Østfold;0119;Marker;;;3070;348;1580;1928;1;2;348;1580;1928;0;2;1;21;
01;Østfold;0121;Rømskog;;;551;69;361;430;0;0;69;361;430;0;0;2;7;
01;Østfold;0122;Trøgstad;;;4212;444;1967;2411;0;0;442;1962;2404;0;2;10;34;
01;Østfold;0123;Spydeberg;;;4392;420;2217;2637;0;0;419;2215;2634;1;5;1;11;
01;Østfold;0124;Askim;;;12234;1644;4939;6583;0;0;1638;4920;6558;10;15;15;59;
01;Østfold;0125;Eidsberg;;;8930;887;3896;4783;0;6;879;3877;4756;5;12;12;60;
01;Østfold;0127;Skiptvet;;;2847;269;1410;1679;0;0;269;1406;1675;0;0;2;17;
01;Østfold;0128;Rakkestad;;;6289;441;2958;3399;0;6;435;2932;3367;5;7;1;27;
01;Østfold;0135;Råde;;;5751;512;3118;3630;0;9;511;3108;3619;2;9;1;28;
01;Østfold;0136;Rygge;;;12082;1249;5639;6888;0;1;1236;5569;6805;12;41;0;27;
01;Østfold;0137;Våler;;;3876;243;2051;2294;0;0;246;2044;2290;0;0;0;24;
01;Østfold;0138;Hobøl;;;4104;287;2671;2958;0;5;286;2053;2339;1;1;2;24;
02;Akershus;0211;Vestby;;;12414;1426;6535;7961;0;0;1411;6438;7849;19;29;6;49;
02;Akershus;0213;Ski;;;22617;2612;11672;14284;4;13;2605;11645;14250;10;12;14;71;
02;Akershus;0214;Ås;;;13752;1387;6839;8226;0;7;1386;6806;8192;8;19;7;61;
02;Akershus;0215;Frogn;;;12300;1921;6156;8077;0;2;1913;6147;8060;8;14;10;55;
02;Akershus;0216;Nesodden;;;14157;2868;6732;9600;1;4;2859;6721;9580;10;20;12;47;
02;Akershus;0217;Oppegård;;;20996;2729;11619;14348;1;8;2712;11486;14198;12;22;13;60;
02;Akershus;0219;Bærum;;;91342;15752;42348;58100;25;68;15714;42302;58016;44;56;65;238;
02;Akershus;0220;Asker;;;44781;7671;21098;28769;0;31;7654;21055;28709;11;15;28;136;
02;Akershus;0221;Aurskog-Høland;;;12412;1258;6080;7338;0;10;1229;6052;7281;6;10;8;59;
02;Akershus;0226;Sørum;;;12654;1057;6517;7574;0;0;1049;6497;7546;6;10;9;72;
02;Akershus;0227;Fet;;;8611;793;4433;5226;0;0;789;4424;5213;2;4;5;36;
02;Akershus;0228;Rælingen;;;13163;1563;5753;7316;1;7;1558;5728;7286;8;10;6;47;
02;Akershus;0229;Enebakk;;;8086;586;4062;4648;0;0;567;4082;4649;3;5;6;32;
02;Akershus;0230;Lørenskog;;;27340;2817;12994;15811;2;10;2803;12888;15691;11;14;9;71;
02;Akershus;0231;Skedsmo;;;39944;5531;16965;22496;6;17;5517;16941;22458;15;17;14;100;
02;Akershus;0233;Nittedal;;;17097;1800;8930;10730;0;9;1789;8820;10609;10;45;16;71;
02;Akershus;0234;Gjerdrum;;;4741;365;2628;2993;0;2;362;2606;2968;0;0;3;18;
02;Akershus;0235;Ullensaker;;;25104;2599;11089;13688;5;32;2559;11045;13604;34;44;29;110;
02;Akershus;0236;Nes;;;16074;1704;7232;8936;1;3;1701;7207;8908;9;12;11;77;
02;Akershus;0237;Eidsvoll;;;17982;1282;8482;9764;0;12;1274;8376;9650;5;11;11;90;
02;Akershus;0238;Nannestad;;;9075;696;4007;4703;0;0;692;3981;4673;4;6;9;40;
02;Akershus;0239;Hurdal;;;2227;328;1036;1364;0;4;323;1026;1349;4;4;1;9;
03;Oslo;0301;Oslo;;;511172;108914;213328;322242;102;368;108470;213206;321676;87;135;417;1253;
04;Hedmark;0402;Kongsvinger;;;14349;1864;5879;7743;0;0;1850;5792;7642;2;2;14;72;
04;Hedmark;0403;Hamar;;;24765;3823;12074;15897;1;12;3803;11982;15785;16;31;15;89;
04;Hedmark;0412;Ringsaker;;;26541;3585;11090;14675;3;16;3550;11051;14601;4;5;28;122;
04;Hedmark;0415;Løten;;;6029;715;2853;3568;0;0;711;2839;3550;8;11;15;50;
04;Hedmark;0417;Stange;;;15793;1796;7976;9772;1;1;1774;7944;9718;14;25;14;75;
04;Hedmark;0418;Nord-Odal;;;4170;381;2079;2460;0;1;390;2044;2434;4;4;12;53;
04;Hedmark;0419;Sør-Odal;;;6357;896;2934;3830;0;2;880;2922;3802;12;15;5;36;
04;Hedmark;0420;Eidskog;;;5142;769;2065;2834;1;1;755;2100;2855;3;3;8;29;
04;Hedmark;0423;Grue;;;4042;421;1932;2353;0;0;417;1926;2343;6;8;6;43;
04;Hedmark;0425;Åsnes;;;6192;767;2559;3326;0;4;756;2546;3302;12;14;3;31;
04;Hedmark;0426;Våler;;;3120;524;1313;1837;0;0;519;1290;1809;8;8;6;19;
04;Hedmark;0427;Elverum;;;16514;2259;7416;9675;1;22;2252;7389;9641;11;15;24;94;
04;Hedmark;0428;Trysil;;;5397;666;2828;3494;0;4;667;2815;3482;0;0;0;22;
04;Hedmark;0429;Åmot;;;3541;507;1586;2093;0;2;499;1581;2080;4;4;10;30;
04;Hedmark;0430;Stor-Elvdal;;;2082;343;981;1324;0;1;340;967;1307;1;1;4;18;
04;Hedmark;0432;Rendalen;;;1561;217;892;1109;0;0;218;890;1108;1;1;1;8;
04;Hedmark;0434;Engerdal;;;1074;166;661;827;0;0;165;661;826;1;1;4;11;
04;Hedmark;0436;Tolga;;;1293;122;788;910;0;0;131;787;918;2;3;4;8;
04;Hedmark;0437;Tynset;;;4268;422;2325;2747;1;3;421;2314;2735;0;1;1;7;
04;Hedmark;0438;Alvdal;;;1832;241;1027;1268;0;3;241;1020;1261;0;2;7;13;
04;Hedmark;0439;Folldal;;;1283;198;780;978;0;0;196;770;966;2;7;3;9;
04;Hedmark;0441;Os;;;1599;197;882;1079;0;1;193;874;1067;1;2;1;10;
05;Oppland;0501;Lillehammer;;;21741;3076;9432;12508;1;1;3042;9367;12409;20;65;8;61;
05;Oppland;0502;Gjøvik;;;23738;2637;10588;13225;3;15;2630;10551;13181;8;15;12;80;
05;Oppland;0511;Dovre;;;2172;340;1027;1367;0;0;338;1023;1361;0;1;2;13;
05;Oppland;0512;Lesja;;;1615;307;804;1111;0;2;306;801;1107;1;1;5;13;
05;Oppland;0513;Skjåk;;;1812;400;852;1252;0;1;398;844;1242;2;4;13;40;
05;Oppland;0514;Lom;;;1883;299;853;1152;0;0;304;881;1185;2;3;6;19;
05;Oppland;0515;Vågå;;;2944;385;1526;1911;0;1;381;1520;1901;5;6;8;26;
05;Oppland;0516;Nord-Fron;;;4588;600;2125;2725;0;2;594;2121;2715;2;3;4;14;
05;Oppland;0517;Sel;;;4720;737;1889;2626;1;3;732;1885;2617;7;7;6;23;
05;Oppland;0519;Sør-Fron;;;2514;247;1260;1507;0;3;242;1257;1499;5;7;1;4;
05;Oppland;0520;Ringebu;;;3592;329;1818;2147;0;1;325;1789;2114;2;2;0;1;
05;Oppland;0521;Øyer;;;4020;517;1950;2467;0;0;515;1943;2458;1;1;8;28;
05;Oppland;0522;Gausdal;;;5152;654;2232;2886;0;1;644;2219;2863;4;5;5;21;
05;Oppland;0528;Østre Toten;;;11877;1110;5825;6935;1;6;1100;5805;6905;10;12;5;52;
05;Oppland;0529;Vestre Toten;;;10491;789;5012;5801;0;6;785;4970;5755;2;12;6;36;
05;Oppland;0532;Jevnaker;;;5216;730;2524;3254;0;6;728;2521;3249;3;4;3;16;
05;Oppland;0533;Lunner;;;6955;740;3714;4454;0;6;736;3681;4417;0;8;9;56;
05;Oppland;0534;Gran;;;10746;1321;5328;6649;2;24;1295;5309;6604;20;25;4;43;
05;Oppland;0536;Søndre Land;;;4627;528;1978;2506;0;0;524;1973;2497;2;3;3;15;
05;Oppland;0538;Nordre Land;;;5398;716;2703;3419;1;3;711;2651;3362;2;2;3;16;
05;Oppland;0540;Sør-Aurdal;;;2465;187;1343;1530;0;0;183;1341;1524;3;3;3;12;
05;Oppland;0541;Etnedal;;;1041;242;470;712;0;0;240;469;709;1;1;1;11;
05;Oppland;0542;Nord-Aurdal;;;5174;471;2349;2820;0;7;464;2339;2803;8;12;5;21;
05;Oppland;0543;Vestre Slidre;;;1738;166;1015;1181;0;0;162;1006;1168;4;7;4;8;
05;Oppland;0544;Øystre Slidre;;;2548;249;1249;1498;0;0;243;1241;1484;7;7;2;4;
05;Oppland;0545;Vang;;;1237;189;689;878;0;2;185;686;871;3;5;1;3;
06;Buskerud;0602;Drammen;;;52294;8976;20268;29244;5;25;8970;20213;29183;13;16;37;137;
06;Buskerud;0604;Kongsberg;;;20788;2658;9924;12582;0;0;2631;9671;12302;6;11;18;103;
06;Buskerud;0605;Ringerike;;;23806;3212;9374;12586;0;8;3186;9353;12539;28;37;28;88;
06;Buskerud;0612;Hole;;;5149;729;2376;3105;0;2;724;2373;3097;3;3;2;21;
06;Buskerud;0615;Flå;;;854;150;433;583;0;1;147;430;577;1;1;1;2;
06;Buskerud;0616;Nes;;;2751;322;1407;1729;0;4;318;1378;1696;4;4;1;11;
06;Buskerud;0617;Gol;;;3594;617;1559;2176;2;3;617;1560;2177;0;0;1;11;
06;Buskerud;0618;Hemsedal;;;1771;352;868;1220;0;6;351;868;1219;2;2;0;4;
06;Buskerud;0619;Ål;;;3657;498;1836;2334;0;2;492;1833;2325;9;9;1;12;
06;Buskerud;0620;Hol;;;3624;607;1587;2194;0;1;598;1579;2177;6;6;1;14;
06;Buskerud;0621;Sigdal;;;2793;211;1625;1836;0;4;203;1621;1824;5;6;0;9;
06;Buskerud;0622;Krødsherad;;;1792;213;955;1168;0;0;228;971;1199;1;1;0;3;
06;Buskerud;0623;Modum;;;10880;1251;4986;6237;0;7;1243;4963;6206;0;7;7;45;
06;Buskerud;0624;Øvre Eiker;;;14054;1142;6494;7636;0;5;1142;6466;7608;4;10;9;67;
06;Buskerud;0625;Nedre Eiker;;;18499;2174;8067;10241;0;4;2156;7928;10084;14;24;26;127;
06;Buskerud;0626;Lier;;;19280;1993;9692;11685;0;9;1973;9636;11609;4;14;9;79;
06;Buskerud;0627;Røyken;;;15967;1271;8241;9512;0;16;1253;8179;9432;8;19;13;57;
06;Buskerud;0628;Hurum;;;7372;1123;3305;4428;0;15;1123;3296;4419;2;17;4;46;
06;Buskerud;0631;Flesberg;;;2052;209;1074;1283;0;0;207;1067;1274;1;1;1;9;
06;Buskerud;0632;Rollag;;;1118;109;653;762;0;0;109;651;760;0;0;0;4;
06;Buskerud;0633;Nore og Uvdal;;;2032;229;1107;1336;0;0;230;1106;1336;1;1;2;10;
07;Vestfold;0701;Horten;;;21810;3431;9489;12920;0;0;3423;9461;12884;13;17;19;126;
07;Vestfold;0702;Holmestrand;;;8498;995;4095;5090;4;4;988;4073;5061;7;16;8;41;
07;Vestfold;0704;Tønsberg;;;33317;3626;15784;19410;3;18;3634;15720;19354;22;38;29;153;
07;Vestfold;0706;Sandefjord;;;35796;5252;14916;20168;1;5;5225;14909;20134;1;4;30;132;
07;Vestfold;0709;Larvik;;;34693;3326;16549;19875;0;13;3313;16452;19765;18;29;11;111;
07;Vestfold;0711;Svelvik;;;5277;577;2317;2894;0;0;552;2352;2904;8;9;5;39;
07;Vestfold;0713;Sande;;;7023;863;3773;4636;3;3;845;3739;4584;5;6;5;30;
07;Vestfold;0714;Hof;;;2442;333;1210;1543;0;0;334;1207;1541;0;0;5;13;
07;Vestfold;0716;Re;;;7141;522;3741;4263;3;7;518;3728;4246;5;5;4;58;
07;Vestfold;0719;Andebu;;;4516;304;2176;2480;0;3;288;2165;2453;14;15;0;25;
07;Vestfold;0720;Stokke;;;8965;1419;4284;5703;0;3;1413;4278;5691;0;3;10;46;
07;Vestfold;0722;Nøtterøy;;;16949;2294;8554;10848;0;1;2279;8530;10809;13;21;14;71;
07;Vestfold;0723;Tjøme;;;4073;901;1858;2759;1;1;875;1839;2714;5;6;6;29;
07;Vestfold;0728;Lardal;;;1939;249;1073;1322;0;1;246;1070;1316;3;3;2;9;
08;Telemark;0805;Porsgrunn;;;29278;3176;13344;16520;2;2;3156;13325;16481;16;19;30;137;
08;Telemark;0806;Skien;;;42552;4093;19319;23412;1;21;4083;19275;23358;11;18;27;143;
08;Telemark;0807;Notodden;;;10003;1193;4696;5889;0;2;1185;4650;5835;1;1;7;30;
08;Telemark;0811;Siljan;;;1832;229;1027;1256;0;0;228;1006;1234;1;1;2;2;
08;Telemark;0814;Bamble;;;11165;1307;5237;6544;2;8;1297;5190;6487;11;16;5;35;
08;Telemark;0815;Kragerø;;;8579;1301;3928;5229;0;3;1296;3919;5215;0;1;10;28;
08;Telemark;0817;Drangedal;;;3256;363;1643;2006;0;0;360;1635;1995;2;3;4;24;
08;Telemark;0819;Nome;;;5200;427;2637;3064;3;3;426;2632;3058;0;0;1;11;
08;Telemark;0821;Bø;;;4559;521;2095;2616;0;5;521;2079;2600;0;2;2;19;
08;Telemark;0822;Sauherad;;;3426;255;1597;1852;0;0;255;1583;1838;0;3;2;25;
08;Telemark;0826;Tinn;;;4708;693;2309;3002;0;0;681;2293;2974;10;10;10;38;
08;Telemark;0827;Hjartdal;;;1257;146;748;894;1;1;150;747;897;0;1;0;11;
08;Telemark;0828;Seljord;;;2353;236;1195;1431;0;0;236;1195;1431;0;0;0;4;
08;Telemark;0829;Kviteseid;;;2017;187;999;1186;0;0;188;980;1168;0;0;0;6;
08;Telemark;0830;Nissedal;;;1143;189;599;788;0;0;189;596;785;0;4;3;8;
08;Telemark;0831;Fyresdal;;;1020;165;515;680;0;0;163;514;677;0;0;9;19;
08;Telemark;0833;Tokke;;;1802;243;1040;1283;0;0;241;1045;1286;3;3;4;33;
08;Telemark;0834;Vinje;;;2921;384;1397;1781;0;1;378;1388;1766;4;4;1;13;
09;Aust-Agder;0901;Risør;;;5489;608;2704;3312;1;8;604;2695;3299;7;9;1;12;
09;Aust-Agder;0904;Grimstad;;;16815;2461;7055;9516;0;6;2459;7003;9462;0;2;20;64;
09;Aust-Agder;0906;Arendal;;;34515;4881;14222;19103;5;27;4874;14164;19038;14;25;24;86;
09;Aust-Agder;0911;Gjerstad;;;1972;306;978;1284;0;1;309;973;1282;0;1;1;10;
09;Aust-Agder;0912;Vegårshei;;;1528;253;876;1129;1;3;254;874;1128;0;0;1;5;
09;Aust-Agder;0914;Tvedestrand;;;4775;684;2303;2987;0;6;681;2294;2975;3;3;6;14;
09;Aust-Agder;0919;Froland;;;4208;554;1859;2413;0;1;546;1840;2386;4;5;1;15;
09;Aust-Agder;0926;Lillesand;;;8243;1082;4208;5290;3;3;1079;4213;5292;1;5;3;18;
09;Aust-Agder;0928;Birkenes;;;3753;538;1665;2203;0;3;538;1658;2196;2;2;2;14;
09;Aust-Agder;0929;Åmli;;;1443;154;766;920;0;4;153;763;916;0;0;6;14;
09;Aust-Agder;0935;Iveland;;;976;90;600;690;0;0;90;597;687;0;0;2;8;
09;Aust-Agder;0937;Evje og Hornnes;;;2729;316;1314;1630;0;0;309;1312;1621;4;4;2;16;
09;Aust-Agder;0938;Bygland;;;960;123;535;658;0;0;118;532;650;4;9;0;11;
09;Aust-Agder;0940;Valle;;;985;236;469;705;0;0;231;467;698;3;3;1;5;
09;Aust-Agder;0941;Bykle;;;717;109;376;485;0;0;105;374;479;4;4;0;3;
10;Vest-Agder;1001;Kristiansand;;;67644;8435;31110;39545;8;61;8418;30991;39409;9;10;33;150;
10;Vest-Agder;1002;Mandal;;;12241;1492;5918;7410;1;2;1484;5900;7384;8;26;9;47;
10;Vest-Agder;1003;Farsund;;;7371;1067;3474;4541;0;3;1061;3463;4524;3;16;5;17;
10;Vest-Agder;1004;Flekkefjord;;;7025;930;3251;4181;0;0;921;3302;4223;6;8;4;10;
10;Vest-Agder;1014;Vennesla;;;10757;876;5384;6260;2;11;877;5346;6223;3;5;1;26;
10;Vest-Agder;1017;Songdalen;;;4790;385;2302;2687;0;5;381;2298;2679;5;6;2;18;
10;Vest-Agder;1018;Søgne;;;8440;1619;3488;5107;1;3;1616;3479;5095;8;9;6;26;
10;Vest-Agder;1021;Marnardal;;;1738;195;937;1132;0;0;194;933;1127;2;2;1;4;
10;Vest-Agder;1026;Åseral;;;696;90;442;532;0;0;87;436;523;2;3;0;3;
10;Vest-Agder;1027;Audnedal;;;1275;114;856;970;0;0;114;853;967;0;1;1;1;
10;Vest-Agder;1029;Lindesnes;;;3731;508;1909;2417;0;6;504;1900;2404;4;4;5;16;
10;Vest-Agder;1032;Lyngdal;;;6049;813;2941;3754;0;7;814;2926;3740;3;3;2;10;
10;Vest-Agder;1034;Hægebostad;;;1290;99;842;941;0;0;99;848;947;0;0;0;4;
10;Vest-Agder;1037;Kvinesdal;;;4535;745;2203;2948;0;5;740;2196;2936;0;1;0;2;
10;Vest-Agder;1046;Sirdal;;;1392;322;710;1032;0;1;320;710;1030;1;1;2;6;
11;Rogaland;1101;Eigersund;;;11307;1373;5034;6407;0;0;1369;5025;6394;7;13;5;52;
11;Rogaland;1102;Sandnes;;;54444;4937;25659;30596;1;49;4916;25574;30490;20;34;18;149;
11;Rogaland;1103;Stavanger;;;102869;8275;51664;59939;0;54;8258;51624;59882;20;47;48;286;
11;Rogaland;1106;Haugesund;;;28074;4086;11742;15828;2;21;4038;11684;15722;29;30;25;87;
11;Rogaland;1111;Sokndal;;;2521;279;1350;1629;0;0;278;1345;1623;1;1;1;16;
11;Rogaland;1112;Lund;;;2422;382;1194;1576;0;0;380;1210;1590;0;0;4;10;
11;Rogaland;1114;Bjerkreim;;;2049;213;1272;1485;0;0;213;1265;1478;0;0;1;6;
11;Rogaland;1119;Hå;;;13833;1712;7192;8904;2;8;1710;7150;8860;4;5;6;26;
11;Rogaland;1120;Klepp;;;13627;1632;6415;8047;0;5;1626;6405;8031;5;7;6;48;
11;Rogaland;1121;Time;;;13601;1377;7300;8677;0;2;1368;7275;8643;4;5;7;39;
11;Rogaland;1122;Gjesdal;;;8499;1063;4110;5173;0;9;1057;4092;5149;3;8;6;32;
11;Rogaland;1124;Sola;;;18890;2175;8790;10965;2;9;2152;8748;10900;7;11;6;37;
11;Rogaland;1127;Randaberg;;;7919;1010;4148;5158;0;2;1005;3956;4961;2;7;5;47;
11;Rogaland;1129;Forsand;;;896;126;537;663;0;0;126;534;660;0;0;3;3;
11;Rogaland;1130;Strand;;;9079;895;4435;5330;2;15;892;4437;5329;2;2;0;26;
11;Rogaland;1133;Hjelmeland;;;2019;284;1140;1424;1;5;282;1133;1415;1;2;0;3;
11;Rogaland;1134;Suldal;;;2933;323;1664;1987;0;0;319;1647;1966;0;0;3;9;
11;Rogaland;1135;Sauda;;;3702;615;1898;2513;0;1;607;1893;2500;6;6;5;14;
11;Rogaland;1141;Finnøy;;;2346;268;1318;1586;0;11;262;1326;1588;5;5;2;10;
11;Rogaland;1142;Rennesøy;;;3419;319;1935;2254;0;0;313;1934;2247;6;6;3;19;
11;Rogaland;1144;Kvitsøy;;;394;40;278;318;0;1;39;276;315;1;2;1;5;
11;Rogaland;1145;Bokn;;;648;115;371;486;0;0;113;368;481;1;6;0;0;
11;Rogaland;1146;Tysvær;;;7930;1190;3775;4965;0;2;1174;3750;4924;4;10;5;15;
11;Rogaland;1149;Karmøy;;;31759;4605;13626;18231;0;0;4591;13579;18170;9;9;26;112;
11;Rogaland;1151;Utsira;;;159;63;71;134;0;0;60;71;131;3;3;0;1;
11;Rogaland;1160;Vindafjord;;;6468;590;3224;3814;0;5;584;3208;3792;4;5;2;13;
12;Hordaland;1201;Bergen;;;214252;45177;87772;132949;29;90;44932;87044;131976;82;98;342;1130;
12;Hordaland;1211;Etne;;;3101;466;1566;2032;0;2;462;1556;2018;6;6;1;6;
12;Hordaland;1216;Sveio;;;4051;677;1875;2552;0;0;674;1875;2549;2;4;6;19;
12;Hordaland;1219;Bømlo;;;8697;1211;4311;5522;0;0;1209;4280;5489;2;3;2;31;
12;Hordaland;1221;Stord;;;13946;2357;6434;8791;0;8;2348;6417;8765;5;11;23;90;
12;Hordaland;1222;Fitjar;;;2285;275;1344;1619;0;0;275;1340;1615;1;2;1;11;
12;Hordaland;1223;Tysnes;;;2207;370;1161;1531;0;1;367;1150;1517;0;0;1;12;
12;Hordaland;1224;Kvinnherad;;;10178;1913;3882;5795;0;1;1921;3807;5728;3;3;9;24;
12;Hordaland;1227;Jondal;;;884;172;462;634;0;0;169;468;637;3;5;1;6;
12;Hordaland;1228;Odda;;;5572;1126;2403;3529;0;2;1118;2394;3512;9;10;11;32;
12;Hordaland;1231;Ullensvang;;;2617;601;1102;1703;0;3;593;1097;1690;6;6;2;8;
12;Hordaland;1232;Eidfjord;;;763;137;386;523;0;0;134;384;518;3;3;0;2;
12;Hordaland;1233;Ulvik;;;887;199;447;646;0;3;197;447;644;4;7;4;8;
12;Hordaland;1234;Granvin;;;760;141;415;556;0;0;141;404;545;0;0;1;3;
12;Hordaland;1235;Voss;;;11082;1661;5243;6904;0;7;1650;5226;6876;8;13;6;41;
12;Hordaland;1238;Kvam;;;6580;1049;3201;4250;1;9;1042;3190;4232;7;7;3;16;
12;Hordaland;1241;Fusa;;;2917;441;1535;1976;0;1;439;1523;1962;2;2;3;13;
12;Hordaland;1242;Samnanger;;;1922;250;1017;1267;0;4;251;1014;1265;0;0;1;8;
12;Hordaland;1243;Os;;;14255;2504;7046;9550;3;12;2484;7029;9513;19;20;17;59;
12;Hordaland;1244;Austevoll;;;3814;564;2023;2587;1;10;563;2006;2569;1;1;1;14;
12;Hordaland;1245;Sund;;;4997;607;2226;2833;0;2;604;2218;2822;3;3;6;30;
12;Hordaland;1246;Fjell;;;18104;2350;8027;10377;0;0;2342;7999;10341;2;16;12;88;
12;Hordaland;1247;Askøy;;;20435;2643;9890;12533;0;6;2639;9847;12486;7;8;15;100;
12;Hordaland;1251;Vaksdal;;;3231;446;1646;2092;0;5;445;1637;2082;3;4;2;17;
12;Hordaland;1252;Modalen;;;281;40;189;229;0;1;40;189;229;0;1;1;1;
12;Hordaland;1253;Osterøy;;;5980;767;3220;3987;0;6;765;3212;3977;1;1;8;45;
12;Hordaland;1256;Meland;;;5643;781;2819;3600;1;5;774;2826;3600;5;6;4;24;
12;Hordaland;1259;Øygarden;;;3549;762;1662;2424;1;6;759;1654;2413;3;7;3;8;
12;Hordaland;1260;Radøy;;;3860;434;2022;2456;1;1;432;2012;2444;5;8;2;12;
12;Hordaland;1263;Lindås;;;11528;1487;5662;7149;0;8;1475;5635;7110;8;11;9;49;
12;Hordaland;1264;Austrheim;;;2177;403;968;1371;0;0;401;976;1377;2;3;1;8;
12;Hordaland;1265;Fedje;;;439;121;246;367;0;0;120;244;364;1;1;0;2;
12;Hordaland;1266;Masfjorden;;;1346;238;713;951;0;0;235;712;947;1;1;1;3;
14;Sogn og Fjordane;1401;Flora;;;8930;1300;4322;5622;0;0;1298;4318;5616;5;5;6;29;
14;Sogn og Fjordane;1411;Gulen;;;1842;331;957;1288;0;2;329;954;1283;2;2;3;8;
14;Sogn og Fjordane;1412;Solund;;;639;173;217;390;0;0;179;226;405;3;3;4;8;
14;Sogn og Fjordane;1413;Hyllestad;;;1118;214;466;680;0;0;214;460;674;0;0;1;2;
14;Sogn og Fjordane;1416;Høyanger;;;3228;400;1696;2096;0;1;400;1694;2094;5;5;2;11;
14;Sogn og Fjordane;1417;Vik;;;2117;257;1107;1364;0;4;255;1101;1356;2;2;1;1;
14;Sogn og Fjordane;1418;Balestrand;;;1024;153;582;735;0;3;152;582;734;0;0;4;5;
14;Sogn og Fjordane;1419;Leikanger;;;1763;292;968;1260;1;1;291;966;1257;0;0;8;17;
14;Sogn og Fjordane;1420;Sogndal;;;5885;752;3122;3874;0;0;748;3097;3845;6;6;7;19;
14;Sogn og Fjordane;1421;Aurland;;;1380;199;746;945;0;4;199;745;944;0;0;1;7;
14;Sogn og Fjordane;1422;Lærdal;;;1715;259;982;1241;0;1;262;979;1241;0;0;5;8;
14;Sogn og Fjordane;1424;Årdal;;;4309;612;2301;2913;0;0;639;2293;2932;0;6;9;23;
14;Sogn og Fjordane;1426;Luster;;;4046;715;2267;2982;0;2;714;2257;2971;1;1;2;4;
14;Sogn og Fjordane;1428;Askvoll;;;2405;339;1291;1630;1;1;336;1274;1610;1;1;5;15;
14;Sogn og Fjordane;1429;Fjaler;;;2102;289;1169;1458;0;0;289;1169;1458;0;4;1;4;
14;Sogn og Fjordane;1430;Gaular;;;2215;339;1105;1444;0;4;333;1109;1442;2;2;0;12;
14;Sogn og Fjordane;1431;Jølster;;;2225;298;1273;1571;1;9;296;1269;1565;3;3;1;9;
14;Sogn og Fjordane;1432;Førde;;;9543;1362;4456;5818;0;6;1348;4429;5777;8;10;6;20;
14;Sogn og Fjordane;1433;Naustdal;;;2141;335;1218;1553;0;0;332;1219;1551;1;1;3;6;
14;Sogn og Fjordane;1438;Bremanger;;;2983;368;1450;1818;0;0;363;1438;1801;5;5;4;12;
14;Sogn og Fjordane;1439;Vågsøy;;;4667;684;2043;2727;0;0;678;2030;2708;5;7;2;15;
14;Sogn og Fjordane;1441;Selje;;;2219;317;1083;1400;0;0;315;1081;1396;1;4;5;13;
14;Sogn og Fjordane;1443;Eid;;;4742;751;2430;3181;0;7;748;2414;3162;6;6;2;13;
14;Sogn og Fjordane;1444;Hornindal;;;937;141;547;688;0;0;137;544;681;3;4;1;2;
14;Sogn og Fjordane;1445;Gloppen;;;4419;809;2338;3147;0;1;811;2335;3146;3;4;3;11;
14;Sogn og Fjordane;1449;Stryn;;;5344;645;2527;3172;0;0;650;2470;3120;4;4;6;17;
15;Møre og Romsdal;1502;Molde;;;20596;2799;9099;11898;0;7;2789;9054;11843;9;12;13;44;
15;Møre og Romsdal;1504;Ålesund;;;35562;5036;13609;18645;3;33;5013;13569;18582;8;10;28;93;
15;Møre og Romsdal;1505;Kristiansund;;;19760;2610;8565;11175;4;18;2561;8500;11061;31;44;36;158;
15;Møre og Romsdal;1511;Vanylven;;;2637;347;1327;1674;0;6;347;1323;1670;0;0;1;10;
15;Møre og Romsdal;1514;Sande;;;2010;228;1021;1249;0;1;225;1019;1244;3;3;2;3;
15;Møre og Romsdal;1515;Herøy;;;6785;804;3265;4069;0;2;795;3240;4035;3;3;3;15;
15;Møre og Romsdal;1516;Ulstein;;;6089;630;3005;3635;0;4;622;2999;3621;1;1;4;17;
15;Møre og Romsdal;1517;Hareid;;;3909;396;1979;2375;0;1;392;1970;2362;4;8;2;13;
15;Møre og Romsdal;1519;Volda;;;6854;846;3555;4401;0;8;844;3543;4387;5;6;5;28;
15;Møre og Romsdal;1520;Ørsta;;;8174;895;3809;4704;1;11;887;3777;4664;4;8;4;25;
15;Møre og Romsdal;1523;Ørskog;;;1778;196;911;1107;0;0;199;903;1102;0;0;4;4;
15;Møre og Romsdal;1524;Norddal;;;1293;170;635;805;0;0;159;624;783;6;6;17;75;
15;Møre og Romsdal;1525;Stranda;;;3548;690;1596;2286;0;0;687;1577;2264;2;2;3;10;
15;Møre og Romsdal;1526;Stordal;;;781;103;382;485;0;0;100;382;482;2;4;1;5;
15;Møre og Romsdal;1528;Sykkylven;;;5875;719;2821;3540;0;2;719;2814;3533;3;5;4;15;
15;Møre og Romsdal;1529;Skodje;;;3327;316;1575;1891;0;1;310;1571;1881;5;6;0;21;
15;Møre og Romsdal;1531;Sula;;;6464;529;3048;3577;0;8;526;3023;3549;3;4;5;29;
15;Møre og Romsdal;1532;Giske;;;5852;555;3011;3566;0;4;552;3007;3559;5;8;3;16;
15;Møre og Romsdal;1534;Haram;;;6968;518;3459;3977;0;7;518;3451;3969;1;2;3;20;
15;Møre og Romsdal;1535;Vestnes;;;5233;650;2412;3062;0;3;638;2396;3034;6;6;2;10;
15;Møre og Romsdal;1539;Rauma;;;5879;1034;2577;3611;0;5;1019;2547;3566;8;13;4;11;
15;Møre og Romsdal;1543;Nesset;;;2377;241;1259;1500;0;1;239;1258;1497;1;1;1;5;
15;Møre og Romsdal;1545;Midsund;;;1538;148;801;949;0;0;147;814;961;1;2;1;6;
15;Møre og Romsdal;1546;Sandøy;;;979;172;491;663;0;5;172;489;661;0;0;3;5;
15;Møre og Romsdal;1547;Aukra;;;2577;305;1330;1635;5;9;304;1328;1632;3;4;2;15;
15;Møre og Romsdal;1548;Fræna;;;7443;655;3454;4109;0;7;652;3423;4075;6;8;8;24;
15;Møre og Romsdal;1551;Eide;;;2622;263;1297;1560;1;3;260;1295;1555;1;1;1;14;
15;Møre og Romsdal;1554;Averøy;;;4499;635;2120;2755;0;1;632;2067;2699;6;6;4;13;
15;Møre og Romsdal;1557;Gjemnes;;;1996;270;1015;1285;0;3;270;1010;1280;0;0;2;7;
15;Møre og Romsdal;1560;Tingvoll;;;2425;309;1268;1577;0;3;307;1265;1572;1;2;2;14;
15;Møre og Romsdal;1563;Sunndal;;;5606;776;2753;3529;1;4;771;2731;3502;2;3;0;14;
15;Møre og Romsdal;1566;Surnadal;;;4744;529;2407;2936;0;2;527;2406;2933;2;2;3;12;
15;Møre og Romsdal;1567;Rindal;;;1603;250;867;1117;0;1;248;857;1105;0;0;3;19;
15;Møre og Romsdal;1571;Halsa;;;1243;196;609;805;0;0;196;616;812;0;0;1;9;
15;Møre og Romsdal;1573;Smøla;;;1731;283;848;1131;1;1;279;839;1118;2;2;1;6;
15;Møre og Romsdal;1576;Aure;;;2795;466;1266;1732;0;0;486;1262;1748;3;4;2;11;
16;Sør-Trøndelag;1601;Trondheim;;;144568;28008;59893;87901;72;182;27938;59821;87759;75;101;160;538;
16;Sør-Trøndelag;1612;Hemne;;;3312;373;1733;2106;0;0;372;1732;2104;1;1;1;7;
16;Sør-Trøndelag;1613;Snillfjord;;;810;71;454;525;0;0;71;452;523;0;0;3;11;
16;Sør-Trøndelag;1617;Hitra;;;3549;459;1395;1854;0;5;454;1382;1836;2;3;2;5;
16;Sør-Trøndelag;1620;Frøya;;;3497;490;1351;1841;0;1;490;1351;1841;1;1;2;9;
16;Sør-Trøndelag;1621;Ørland;;;4084;689;1862;2551;0;5;683;1858;2541;3;6;5;25;
16;Sør-Trøndelag;1622;Agdenes;;;1399;207;752;959;1;3;205;746;951;2;2;2;4;
16;Sør-Trøndelag;1624;Rissa;;;5127;672;2614;3286;1;16;668;2599;3267;0;4;3;17;
16;Sør-Trøndelag;1627;Bjugn;;;3693;474;1604;2078;0;1;471;1601;2072;3;6;7;22;
16;Sør-Trøndelag;1630;Åfjord;;;2599;350;1277;1627;0;0;345;1320;1665;5;5;2;6;
16;Sør-Trøndelag;1632;Roan;;;791;122;392;514;0;0;122;391;513;0;0;1;5;
16;Sør-Trøndelag;1633;Osen;;;793;173;370;543;0;0;173;369;542;0;0;3;5;
16;Sør-Trøndelag;1634;Oppdal;;;5344;784;2422;3206;0;5;781;2417;3198;1;1;6;29;
16;Sør-Trøndelag;1635;Rennebu;;;2049;230;1063;1293;0;1;226;1063;1289;3;4;3;14;
16;Sør-Trøndelag;1636;Meldal;;;3124;563;1585;2148;0;0;561;1577;2138;0;1;3;10;
16;Sør-Trøndelag;1638;Orkdal;;;9065;1089;4013;5102;0;4;1090;4008;5098;4;8;6;33;
16;Sør-Trøndelag;1640;Røros;;;4602;547;2683;3230;0;0;546;2739;3285;1;1;3;46;
16;Sør-Trøndelag;1644;Holtålen;;;1626;250;906;1156;0;0;251;916;1167;0;1;2;20;
16;Sør-Trøndelag;1648;Midtre Gauldal;;;4862;669;2335;3004;0;3;663;2328;2991;3;5;2;14;
16;Sør-Trøndelag;1653;Melhus;;;12070;1538;5834;7372;1;16;1525;5804;7329;9;10;7;53;
16;Sør-Trøndelag;1657;Skaun;;;5655;544;2985;3529;0;0;540;2969;3509;0;0;4;20;
16;Sør-Trøndelag;1662;Klæbu;;;4592;486;2223;2709;0;0;480;2210;2690;8;8;5;35;
16;Sør-Trøndelag;1663;Malvik;;;10100;1658;4490;6148;0;5;1654;4464;6118;6;21;9;38;
16;Sør-Trøndelag;1664;Selbu;;;3222;311;1768;2079;0;1;310;1763;2073;1;1;0;18;
16;Sør-Trøndelag;1665;Tydal;;;710;176;379;555;0;0;175;378;553;1;1;2;8;
17;Nord-Trøndelag;1702;Steinkjer;;;17007;2608;7340;9948;0;3;2599;7343;9942;11;18;18;72;
17;Nord-Trøndelag;1703;Namsos;;;9927;1104;4458;5562;0;4;1097;4433;5530;4;4;1;27;
17;Nord-Trøndelag;1711;Meråker;;;2014;360;931;1291;0;0;359;929;1288;1;3;3;14;
17;Nord-Trøndelag;1714;Stjørdal;;;17592;2540;8530;11070;1;17;2539;8480;11019;9;17;23;67;
17;Nord-Trøndelag;1717;Frosta;;;2011;247;1075;1322;0;0;244;1068;1312;3;3;0;9;
17;Nord-Trøndelag;1718;Leksvik;;;2726;512;1441;1953;0;3;500;1441;1941;4;4;5;10;
17;Nord-Trøndelag;1719;Levanger;;;14970;2347;6583;8930;0;14;2341;6553;8894;5;6;14;55;
17;Nord-Trøndelag;1721;Verdal;;;11489;1891;4445;6336;0;6;1885;4423;6308;1;3;8;36;
17;Nord-Trøndelag;1724;Verran;;;2036;207;990;1197;0;1;201;988;1189;3;5;1;16;
17;Nord-Trøndelag;1725;Namdalseid;;;1348;127;726;853;0;2;123;723;846;2;3;1;4;
17;Nord-Trøndelag;1736;Snåsa;;;1701;261;968;1229;1;1;261;966;1227;0;1;0;5;
17;Nord-Trøndelag;1738;Lierne;;;1099;154;558;712;0;0;153;556;709;1;3;2;4;
17;Nord-Trøndelag;1739;Røyrvik;;;383;95;194;289;0;0;94;194;288;1;1;0;2;
17;Nord-Trøndelag;1740;Namsskogan;;;713;134;358;492;0;0;134;357;491;0;1;6;9;
17;Nord-Trøndelag;1742;Grong;;;1919;310;1021;1331;0;3;309;1021;1330;0;0;0;6;
17;Nord-Trøndelag;1743;Høylandet;;;939;142;574;716;0;0;141;572;713;0;0;0;0;
17;Nord-Trøndelag;1744;Overhalla;;;2835;346;1545;1891;0;2;344;1529;1873;1;1;2;7;
17;Nord-Trøndelag;1748;Fosnes;;;522;83;267;350;0;0;78;264;342;6;9;0;2;
17;Nord-Trøndelag;1749;Flatanger;;;896;155;430;585;0;0;157;430;587;1;1;0;1;
17;Nord-Trøndelag;1750;Vikna;;;3302;388;1546;1934;0;1;386;1544;1930;0;0;2;15;
17;Nord-Trøndelag;1751;Nærøy;;;3978;485;1828;2313;3;7;473;1820;2293;18;20;0;10;
17;Nord-Trøndelag;1755;Leka;;;479;77;247;324;0;1;77;246;323;0;0;2;17;
17;Nord-Trøndelag;1756;Inderøy;;;5196;619;2856;3475;0;8;614;2811;3425;3;6;2;24;
18;Nordland;1804;Bodø;;;38746;6324;16571;22895;2;20;6307;16515;22822;38;62;16;103;
18;Nordland;1805;Narvik;;;14757;1510;6693;8203;0;2;1496;6685;8181;7;10;22;108;
18;Nordland;1811;Bindal;;;1211;287;679;966;0;0;286;673;959;0;0;0;1;
18;Nordland;1812;Sømna;;;1587;202;935;1137;0;1;200;933;1133;2;2;1;3;
18;Nordland;1813;Brønnøy;;;6110;657;2784;3441;0;0;650;2896;3546;6;6;11;35;
18;Nordland;1815;Vega;;;1007;241;503;744;0;0;237;500;737;2;2;2;6;
18;Nordland;1816;Vevelstad;;;402;126;150;276;1;1;126;149;275;1;2;1;1;
18;Nordland;1818;Herøy;;;1386;162;569;731;0;0;158;563;721;0;0;0;6;
18;Nordland;1820;Alstahaug;;;5743;851;2267;3118;0;5;841;2259;3100;7;9;5;14;
18;Nordland;1822;Leirfjord;;;1733;303;814;1117;0;6;302;804;1106;1;1;1;4;
18;Nordland;1824;Vefsn;;;10602;1667;4565;6232;0;0;1660;4555;6215;4;6;16;36;
18;Nordland;1825;Grane;;;1154;271;562;833;1;1;272;562;834;0;0;0;4;
18;Nordland;1826;Hattfjelldal;;;1157;213;655;868;0;0;212;654;866;0;1;2;4;
18;Nordland;1827;Dønna;;;1104;164;565;729;0;3;163;552;715;2;2;4;11;
18;Nordland;1828;Nesna;;;1388;228;645;873;1;1;226;637;863;0;3;4;17;
18;Nordland;1832;Hemnes;;;3578;400;1996;2396;0;0;397;2012;2409;1;1;3;10;
18;Nordland;1833;Rana;;;20495;3332;8118;11450;0;9;3303;7939;11242;25;35;20;58;
18;Nordland;1834;Lurøy;;;1521;177;821;998;0;0;176;814;990;0;0;0;3;
18;Nordland;1835;Træna;;;349;84;135;219;0;0;84;135;219;0;3;2;5;
18;Nordland;1836;Rødøy;;;966;195;473;668;0;1;192;467;659;2;2;1;2;
18;Nordland;1837;Meløy;;;5021;956;2271;3227;0;2;949;2168;3117;2;7;2;6;
18;Nordland;1838;Gildeskål;;;1592;212;814;1026;0;3;210;812;1022;4;4;1;3;
18;Nordland;1839;Beiarn;;;871;152;501;653;0;2;153;497;650;1;1;3;11;
18;Nordland;1840;Saltdal;;;3745;450;2000;2450;0;0;447;1994;2441;5;5;4;29;
18;Nordland;1841;Fauske;;;7647;1090;3793;4883;0;14;1074;3779;4853;4;6;2;25;
18;Nordland;1845;Sørfold;;;1564;237;805;1042;0;1;236;801;1037;2;3;0;12;
18;Nordland;1848;Steigen;;;2068;382;892;1274;0;0;376;915;1291;5;5;1;3;
18;Nordland;1849;Hamarøy;;;1451;268;670;938;0;2;264;683;947;5;5;1;4;
18;Nordland;1850;Tysfjord;;;1663;521;787;1308;1;5;517;774;1291;3;3;2;3;
18;Nordland;1851;Lødingen;;;1713;311;872;1183;0;0;315;869;1184;1;1;2;8;
18;Nordland;1852;Tjeldsund;;;1053;102;599;701;0;2;101;595;696;1;2;0;2;
18;Nordland;1853;Evenes;;;1076;168;605;773;0;1;162;527;689;4;4;1;4;
18;Nordland;1854;Ballangen;;;2051;209;921;1130;0;0;209;919;1128;1;1;7;29;
18;Nordland;1856;Røst;;;436;112;222;334;0;0;111;222;333;2;2;3;13;
18;Nordland;1857;Værøy;;;589;160;211;371;0;0;158;211;369;2;2;0;2;
18;Nordland;1859;Flakstad;;;1092;105;509;614;1;3;104;509;613;1;1;2;8;
18;Nordland;1860;Vestvågøy;;;8519;1290;3636;4926;0;0;1282;3614;4896;11;15;7;25;
18;Nordland;1865;Vågan;;;7176;1036;2901;3937;0;11;1019;2887;3906;12;12;4;13;
18;Nordland;1866;Hadsel;;;6334;957;2846;3803;0;0;946;2808;3754;11;13;3;24;
18;Nordland;1867;Bø;;;2168;534;1063;1597;0;6;530;1062;1592;3;3;3;8;
18;Nordland;1868;Øksnes;;;3470;617;1315;1932;0;5;613;1312;1925;0;1;8;19;
18;Nordland;1870;Sortland;;;7841;1178;3511;4689;0;9;1173;3490;4663;2;3;3;11;
18;Nordland;1871;Andøy;;;3940;472;1956;2428;0;6;471;1943;2414;3;4;2;11;
18;Nordland;1874;Moskenes;;;852;201;284;485;3;3;200;281;481;2;2;4;8;
19;Troms Romsa;1902;Tromsø;;;55959;8790;23894;32684;1;66;8734;24906;33640;47;64;58;292;
19;Troms Romsa;1903;Harstad;;;19256;2436;8183;10619;0;22;2433;8162;10595;1;7;18;70;
19;Troms Romsa;1911;Kvæfjord;;;2396;267;1105;1372;0;4;261;1102;1363;5;5;2;9;
19;Troms Romsa;1913;Skånland;;;2380;321;1153;1474;0;1;317;1150;1467;1;1;1;7;
19;Troms Romsa;1917;Ibestad;;;1163;196;509;705;0;1;194;508;702;1;1;1;4;
19;Troms Romsa;1919;Gratangen;;;902;178;423;601;0;0;177;423;600;2;3;1;6;
19;Troms Romsa;1920;Lavangen;;;790;118;461;579;0;0;117;459;576;1;4;2;3;
19;Troms Romsa;1922;Bardu;;;3097;402;1452;1854;0;3;398;1446;1844;6;6;7;26;
19;Troms Romsa;1923;Salangen;;;1721;245;865;1110;0;13;241;870;1111;3;4;1;19;
19;Troms Romsa;1924;Målselv;;;5454;542;2490;3032;0;8;533;2487;3020;9;10;7;24;
19;Troms Romsa;1925;Sørreisa;;;2647;291;1275;1566;0;5;290;1274;1564;3;3;1;10;
19;Troms Romsa;1926;Dyrøy;;;957;161;516;677;0;5;160;512;672;2;2;2;6;
19;Troms Romsa;1927;Tranøy;;;1226;135;633;768;0;1;135;633;768;2;3;0;1;
19;Troms Romsa;1928;Torsken;;;713;126;311;437;0;0;124;308;432;1;1;2;16;
19;Troms Romsa;1929;Berg;;;704;166;351;517;0;0;166;344;510;0;0;2;6;
19;Troms Romsa;1931;Lenvik;;;8725;1132;3481;4613;1;11;1122;3473;4595;7;7;7;25;
19;Troms Romsa;1933;Balsfjord;;;4543;394;2174;2568;0;7;387;2168;2555;4;4;3;15;
19;Troms Romsa;1936;Karlsøy;;;1880;212;809;1021;0;3;206;803;1009;5;5;3;13;
19;Troms Romsa;1938;Lyngen;;;2357;454;1119;1573;0;5;448;1117;1565;5;6;1;8;
19;Troms Romsa;1939;Storfjord;;;1492;253;881;1134;0;1;251;880;1131;0;0;2;5;
19;Troms Romsa;1940;Gáivuotna Kåfjord;;;1770;125;931;1056;0;0;125;932;1057;0;0;3;6;
19;Troms Romsa;1941;Skjervøy;;;2265;279;1076;1355;0;4;275;1064;1339;2;2;2;2;
19;Troms Romsa;1942;Nordreisa;;;3837;482;1652;2134;0;5;479;1652;2131;4;4;3;23;
19;Troms Romsa;1943;Kvænangen;;;1001;251;398;649;0;0;250;398;648;1;1;1;3;
20;Finnmark Finnmárku;2002;Vardø;;;1706;257;759;1016;0;0;257;759;1016;0;0;1;10;
20;Finnmark Finnmárku;2003;Vadsø;;;4843;746;2306;3052;1;1;737;2315;3052;0;3;7;34;
20;Finnmark Finnmárku;2004;Hammerfest;;;7860;1300;2652;3952;5;5;1295;2645;3940;7;9;9;27;
20;Finnmark Finnmárku;2011;Guovdageaidnu Kautokeino;;;2348;622;960;1582;0;1;619;960;1579;1;1;0;2;
20;Finnmark Finnmárku;2012;Alta;;;14896;3664;4707;8371;4;5;3644;4698;8342;6;9;27;64;
20;Finnmark Finnmárku;2014;Loppa;;;828;138;409;547;0;1;137;405;542;0;0;0;6;
20;Finnmark Finnmárku;2015;Hasvik;;;825;128;393;521;0;1;128;391;519;0;0;0;4;
20;Finnmark Finnmárku;2017;Kvalsund;;;853;99;407;506;0;0;97;407;504;4;4;1;7;
20;Finnmark Finnmárku;2018;Måsøy;;;996;204;350;554;0;1;202;350;552;2;2;0;7;
20;Finnmark Finnmárku;2019;Nordkapp;;;2568;401;917;1318;0;0;391;906;1297;9;9;7;15;
20;Finnmark Finnmárku;2020;Porsanger Porsángu Porsanki;;;3183;647;1506;2153;1;8;640;1502;2142;7;7;2;13;
20;Finnmark Finnmárku;2021;Kárásjohka Karasjok;;;2170;362;1072;1434;0;0;370;1070;1440;1;1;3;10;
20;Finnmark Finnmárku;2022;Lebesby;;;1056;259;427;686;0;0;259;425;684;3;3;1;4;
20;Finnmark Finnmárku;2023;Gamvik;;;871;187;378;565;0;0;190;373;563;0;1;3;3;
20;Finnmark Finnmárku;2024;Berlevåg;;;808;126;324;450;1;1;122;322;444;4;4;5;16;
20;Finnmark Finnmárku;2025;Deatnu Tana;;;2335;322;1075;1397;1;3;319;1071;1390;0;0;4;13;
20;Finnmark Finnmárku;2027;Unjárga Nesseby;;;750;182;341;523;0;0;182;341;523;1;3;3;8;
20;Finnmark Finnmárku;2028;Båtsfjord;;;1671;362;679;1041;0;4;360;674;1034;1;2;5;24;
20;Finnmark Finnmárku;2030;Sør-Varanger;;;7888;1132;3346;4478;0;0;1096;3327;4423;1;9;5;29;
